Uno=one.
Dos=two.
Tres=three.
Cuatro=four.
Cinco=five.
Seis=six.
Siete=seven.
Ocho=eight.
Nueve=nine.
Diez=ten.
Once=eleven.
Doce=twelve.
Trece=thirteen.
Catorce=fourteen.
Quince=fiveteen.
Dieciseis=sixteen.
Diecisiete=seventeen.
Dieciocho=eighteen.
Diecinueve=nineteen.
Veinte=twenty.
Veintiuno=twenty one.
Veintidos=twenty two.
Veintitres=twenty three.
Veinticuatro=twenty four.
Veinticinco=twenty five.
Veintiseis=twenty six.
Veintisiete=twenty seven.
Veintiocho=twenty eight.
Veintinueve=twenty nine.
Treinta=thyirty.
Treinta Y Uno=thirthy one.
Treinta Y Dos=thirthy two.
Treinta Y Tres=thirthy three.
Treinta Y Cuatro=thirthy four.
Treinta Y Cinco=thirthy five.
Treinta Y Seis=thirthy six.
Treinta Y Siete=thirthy seven.
Treinta Y Ocho=thirthy eight.
Treinta Y Nueve=thirthy nine.
Cuarenta=fourty.
Cuarenta Y Uno=fourty one.
Cuarenta Y Dos=fourty two.
Cuarenta Y Tres=fourty three.
Cuarenta Y Cuatro=fourty four.
Cuarenta Y Cinco=fourty five.
Cuarenta Y Seis=fourty six.
Cuarenta Y Siete=fourty seven.
Cuarenta Y Ocho=fourty eight.
Cuarenta Y Nueve=fourty nine.
Cincuenta=fifty.
Cincuenta Y Uno=fifty one.
Cincuenta Y Dos=fifty two.
Cincuenta Y Tres=fifty three.
Cincuenta Y Cuatro=fifty four.
Cincuenta Y Cinco=fifty five.
Cincuenta Y Seis=fifty six.
Cincuenta Y Siete=fifty seven.
Cincuenta Y Ocho=fifty eight.
Cincuenta Y Nueve=fifty nine.
Sesenta=sixty.
Sesenta Y Uno=sixty one.
Sesenta Y Dos=sixty two.
Sesenta Y Tres=sixty three.
Sesenta Y Cuatro=sixty four.
Sesenta Y Cinco=sixty five.
Sesenta Y Seis=sixty six.
Sesenta Y Siete=sixty seven.
Sesenta Y Ocho=sixty eight.
Sesenta Y Nueve=sixty nine.
Setenta=seventy.
Setenta Y Uno=seventy one.
Setenta Y Dos=seventy two.
Setenta Y Tres=seventy three.
Setenta Y Cuatro=seventy four.
Setenta Y Cinco=seventy five.
Setenta Y Seis=seventy six.
Setenta Y Siete=seventy seven.
Setenta Y Ocho=seventy eight.
Setenta Y Nueve=seventy nine.
Ochenta=eighty.
Ochenta Y Uno=eighty one.
Ochenta Y Dos=eighty two.
Ochenta Y Tres=eighty three.
Ochenta Y Cuatro=eighty four.
Ochenta Y Cinco=eighty five.
Ochenta Y Seis=eighty six.
Ochenta Y Siete=eighty seven.
Ochenta Y Ocho=eighty eight.
Ochenta Y Nueve=eighty nine.
Noventa=ninety.
Noventa Y Uno=ninety one.
Noventa Y Dos=ninety two.
Noventa Y Tres=ninety three.
Noventa Y Cuatro=ninety four.
Noventa Y Cinco=ninety five.
Noventa Y Seis=ninety six.
Noventa Y Siete=ninety seven.
Noventa Y Ocho=ninety eight.
Noventa Y Nueve=ninety nine.
Cien=one hundred.
